5 6
######
#p   #
#  * #
#   2#
######